1 2 4 3 3 3 3 3 2 1
x 1 1 x 1 1 x 1 1 x
2 x 2 2 x x 2 2 x 2
1 4 1 1 1 1 4 1 4 1
2 3 4 3 2 2 3 3 3 2
1 1 1 1 1 1 1 4 1 1